model_name,acc,MR1,MR1_acc,MR1_correct,MR1_incorrect,non_MR1,non_MR1_acc,non_MR1_correct,non_MR1_incorrect,MR2,MR2_acc,MR2_correct,MR2_incorrect,non_MR2,non_MR2_acc,non_MR2_correct,non_MR2_incorrect,MR1&2,MR1&2_acc,MR1&2_correct,MR1&2_incorrect,non_MR1&2,non_MR1&2_acc,non_MR1&2_correct,non_MR1&2_incorrect,acc_num
resnet_1_epoch_0,18.232%,1795.0,8.412%,151,1644,48205.0,18.598%,8965,39240,44472.0,9.426%,4192,40280,5528.0,89.074%,4924,604,1773,8.065%,143,1630,48227,18.606%,8973,39254,9116
resnet_1_epoch_5,47.912%,1577.0,13.697%,216,1361,48423.0,49.026%,23740,24683,30424.0,19.024%,5788,24636,19576.0,92.808%,18168,1408,1485,13.266%,197,1288,48515,48.972%,23759,24756,23956
resnet_1_epoch_10,52.292%,1608.0,13.557%,218,1390,48392.0,53.579%,25928,22464,27240.0,18.682%,5089,22151,22760.0,92.518%,21057,1703,1466,13.029%,191,1275,48534,53.478%,25955,22579,26146
resnet_1_epoch_15,51.404%,1557.0,13.038%,203,1354,48443.0,52.637%,25499,22944,28092.0,19.119%,5371,22721,21908.0,92.802%,20331,1577,1427,12.544%,179,1248,48573,52.546%,25523,23050,25702
resnet_1_epoch_20,51.152%,1683.0,12.240%,206,1477,48317.0,52.507%,25370,22947,27482.0,17.539%,4820,22662,22518.0,92.175%,20756,1762,1503,12.309%,185,1318,48497,52.356%,25391,23106,25576
resnet_1_epoch_25,53.264%,1505.0,13.621%,205,1300,48495.0,54.494%,26427,22068,26952.0,19.138%,5158,21794,23048.0,93.171%,21474,1574,1379,13.488%,186,1193,48621,54.392%,26446,22175,26632
resnet_1_epoch_30,67.928%,1422.0,20.534%,292,1130,48578.0,69.315%,33672,14906,19071.0,25.458%,4855,14216,30929.0,94.116%,29109,1820,1202,20.133%,242,960,48798,69.105%,33722,15076,33964
resnet_1_epoch_35,70.508%,1425.0,21.895%,312,1113,48575.0,71.934%,34942,13633,17782.0,26.516%,4715,13067,32218.0,94.789%,30539,1679,1184,21.706%,257,927,48816,71.692%,34997,13819,35254
resnet_1_epoch_40,69.954%,1403.0,22.452%,315,1088,48597.0,71.325%,34662,13935,18138.0,26.673%,4838,13300,31862.0,94.592%,30139,1723,1137,21.988%,250,887,48863,71.070%,34727,14136,34977
resnet_1_epoch_45,69.764%,1361.0,21.308%,290,1071,48639.0,71.120%,34592,14047,18352.0,26.531%,4869,13483,31648.0,94.834%,30013,1635,1117,21.486%,240,877,48883,70.867%,34642,14241,34882
resnet_1_epoch_50,69.412%,1312.0,22.256%,292,1020,48688.0,70.683%,34414,14274,18462.0,26.389%,4872,13590,31538.0,94.597%,29834,1704,1114,22.531%,251,863,48886,70.480%,34455,14431,34706
resnet_1_epoch_55,69.780%,1403.0,21.240%,298,1105,48597.0,71.181%,34592,14005,18576.0,27.476%,5104,13472,31424.0,94.787%,29786,1638,1194,20.854%,249,945,48806,70.977%,34641,14165,34890
resnet_1_epoch_60,74.192%,1358.0,24.153%,328,1030,48642.0,75.589%,36768,11874,15918.0,28.961%,4610,11308,34082.0,95.317%,32486,1596,1084,24.446%,265,819,48916,75.294%,36831,12085,37096
resnet_1_epoch_65,74.984%,1375.0,25.673%,353,1022,48625.0,76.378%,37139,11486,15456.0,29.212%,4515,10941,34544.0,95.464%,32977,1567,1090,25.413%,277,813,48910,76.089%,37215,11695,37492
resnet_1_epoch_70,75.278%,1337.0,26.028%,348,989,48663.0,76.631%,37291,11372,15198.0,29.425%,4472,10726,34802.0,95.302%,33167,1635,1034,25.725%,266,768,48966,76.324%,37373,11593,37639
resnet_1_epoch_75,75.416%,1330.0,24.511%,326,1004,48670.0,76.807%,37382,11288,15265.0,30.075%,4591,10674,34735.0,95.342%,33117,1618,1043,24.545%,256,787,48957,76.500%,37452,11505,37708
resnet_1_epoch_80,75.566%,1373.0,23.088%,317,1056,48627.0,77.048%,37466,11161,15069.0,29.557%,4454,10615,34931.0,95.414%,33329,1602,1053,22.697%,239,814,48947,76.703%,37544,11403,37783
resnet_1_epoch_85,75.604%,1327.0,25.320%,336,991,48673.0,76.975%,37466,11207,14967.0,29.325%,4389,10578,35033.0,95.376%,33413,1620,1018,25.246%,257,761,48982,76.651%,37545,11437,37802
resnet_1_epoch_90,76.038%,1373.0,26.948%,370,1003,48627.0,77.424%,37649,10978,14634.0,29.288%,4286,10348,35366.0,95.383%,33733,1633,1044,27.107%,283,761,48956,77.081%,37736,11220,38019
resnet_1_epoch_95,76.300%,1356.0,26.991%,366,990,48644.0,77.675%,37784,10860,14618.0,30.086%,4398,10220,35382.0,95.393%,33752,1630,1033,26.428%,273,760,48967,77.352%,37877,11090,38150
resnet_2_epoch_0,14.634%,1996.0,6.012%,120,1876,48004.0,14.993%,7197,40807,45154.0,7.029%,3174,41980,4846.0,85.493%,4143,703,1976,5.567%,110,1866,48024,15.007%,7207,40817,7317
resnet_2_epoch_5,47.906%,1591.0,13.388%,213,1378,48409.0,49.040%,23740,24669,30739.0,20.105%,6180,24559,19261.0,92.275%,17773,1488,1495,12.977%,194,1301,48505,48.983%,23759,24746,23953
resnet_2_epoch_10,49.888%,1645.0,13.313%,219,1426,48355.0,51.132%,24725,23630,28752.0,18.249%,5247,23505,21248.0,92.700%,19697,1551,1513,12.888%,195,1318,48487,51.043%,24749,23738,24944
resnet_2_epoch_15,55.638%,1448.0,14.019%,203,1245,48552.0,56.879%,27616,20936,25986.0,20.984%,5453,20533,24014.0,93.137%,22366,1648,1301,13.451%,175,1126,48699,56.765%,27644,21055,27819
resnet_2_epoch_20,58.914%,1496.0,14.572%,218,1278,48504.0,60.282%,29239,19265,23912.0,21.245%,5080,18832,26088.0,93.441%,24377,1711,1321,14.534%,192,1129,48679,60.118%,29265,19414,29457
resnet_2_epoch_25,57.114%,1531.0,15.023%,230,1301,48469.0,58.444%,28327,20142,25467.0,21.954%,5591,19876,24533.0,93.613%,22966,1567,1396,15.043%,210,1186,48604,58.322%,28347,20257,28557
resnet_2_epoch_30,70.294%,1390.0,21.871%,304,1086,48610.0,71.679%,34843,13767,18077.0,27.162%,4910,13167,31923.0,94.719%,30237,1686,1146,21.117%,242,904,48854,71.448%,34905,13949,35147
resnet_2_epoch_35,72.266%,1359.0,21.854%,297,1062,48641.0,73.674%,35836,12805,17021.0,28.242%,4807,12214,32979.0,94.988%,31326,1653,1101,21.798%,240,861,48899,73.402%,35893,13006,36133
resnet_2_epoch_40,72.616%,1289.0,22.576%,291,998,48711.0,73.940%,36017,12694,16855.0,28.235%,4759,12096,33145.0,95.185%,31549,1596,1063,22.201%,236,827,48937,73.711%,36072,12865,36308
resnet_2_epoch_45,72.398%,1369.0,23.302%,319,1050,48631.0,73.780%,35880,12751,16939.0,28.443%,4818,12121,33061.0,94.918%,31381,1680,1081,23.404%,253,828,48919,73.481%,35946,12973,36199
resnet_2_epoch_50,72.202%,1385.0,23.321%,323,1062,48615.0,73.595%,35778,12837,17263.0,29.051%,5015,12248,32737.0,94.957%,31086,1651,1122,22.549%,253,869,48878,73.342%,35848,13030,36101
resnet_2_epoch_55,70.938%,1339.0,23.226%,311,1028,48661.0,72.251%,35158,13503,18260.0,28.987%,5293,12967,31740.0,95.072%,30176,1564,1121,23.283%,261,860,48879,72.031%,35208,13671,35469
resnet_2_epoch_60,75.032%,1392.0,25.431%,354,1038,48608.0,76.452%,37162,11446,15431.0,29.966%,4624,10807,34569.0,95.149%,32892,1677,1075,25.581%,275,800,48925,76.119%,37241,11684,37516
resnet_2_epoch_65,75.592%,1398.0,26.896%,376,1022,48602.0,76.993%,37420,11182,15143.0,30.027%,4547,10596,34857.0,95.387%,33249,1608,1082,26.340%,285,797,48918,76.681%,37511,11407,37796
resnet_2_epoch_70,75.612%,1338.0,24.963%,334,1004,48662.0,77.005%,37472,11190,15115.0,29.950%,4527,10588,34885.0,95.396%,33279,1606,1015,24.631%,250,765,48985,76.668%,37556,11429,37806
resnet_2_epoch_75,75.788%,1383.0,26.247%,363,1020,48617.0,77.197%,37531,11086,15018.0,30.084%,4518,10500,34982.0,95.409%,33376,1606,1049,26.406%,277,772,48951,76.846%,37617,11334,37894
resnet_2_epoch_80,75.942%,1398.0,25.393%,355,1043,48602.0,77.396%,37616,10986,14825.0,29.673%,4399,10426,35175.0,95.443%,33572,1603,1064,25.188%,268,796,48936,77.046%,37703,11233,37971
resnet_2_epoch_85,75.778%,1357.0,26.898%,365,992,48643.0,77.142%,37524,11119,14840.0,29.569%,4388,10452,35160.0,95.282%,33501,1659,1015,26.207%,266,749,48985,76.805%,37623,11362,37889
resnet_2_epoch_90,76.024%,1366.0,27.745%,379,987,48634.0,77.380%,37633,11001,14735.0,29.467%,4342,10393,35265.0,95.477%,33670,1595,1048,28.244%,296,752,48952,77.047%,37716,11236,38012
resnet_2_epoch_95,76.114%,1354.0,29.321%,397,957,48646.0,77.416%,37660,10986,14780.0,30.047%,4441,10339,35220.0,95.446%,33616,1604,1011,29.278%,296,715,48989,77.081%,37761,11228,38057
resnet_3_epoch_0,12.818%,2153.0,3.576%,77,2076,47847.0,13.234%,6332,41515,46124.0,6.541%,3017,43107,3876.0,87.513%,3392,484,2138,3.508%,75,2063,47862,13.234%,6334,41528,6409
resnet_3_epoch_5,48.908%,1593.0,13.748%,219,1374,48407.0,50.065%,24235,24172,29688.0,19.355%,5746,23942,20312.0,92.103%,18708,1604,1480,13.108%,194,1286,48520,50.000%,24260,24260,24454
resnet_3_epoch_10,52.726%,1600.0,14.875%,238,1362,48400.0,53.977%,26125,22275,27178.0,19.207%,5220,21958,22822.0,92.643%,21143,1679,1425,14.246%,203,1222,48575,53.855%,26160,22415,26363
resnet_3_epoch_15,56.720%,1486.0,15.209%,226,1260,48514.0,57.992%,28134,20380,25396.0,21.188%,5381,20015,24604.0,93.395%,22979,1625,1318,14.871%,196,1122,48682,57.853%,28164,20518,28360
resnet_3_epoch_20,58.012%,1490.0,14.631%,218,1272,48510.0,59.344%,28788,19722,24515.0,21.056%,5162,19353,25485.0,93.561%,23844,1641,1341,14.914%,200,1141,48659,59.200%,28806,19853,29006
resnet_3_epoch_25,57.022%,1567.0,16.082%,252,1315,48433.0,58.347%,28259,20174,25100.0,20.769%,5213,19887,24900.0,93.566%,23298,1602,1395,15.842%,221,1174,48605,58.204%,28290,20315,28511
resnet_3_epoch_30,70.580%,1384.0,22.327%,309,1075,48616.0,71.954%,34981,13635,17917.0,27.248%,4882,13035,32083.0,94.779%,30408,1675,1150,21.913%,252,898,48850,71.726%,35038,13812,35290
resnet_3_epoch_35,71.936%,1363.0,20.029%,273,1090,48637.0,73.391%,35695,12942,17297.0,28.363%,4906,12391,32703.0,94.982%,31062,1641,1129,19.398%,219,910,48871,73.150%,35749,13122,35968
resnet_3_epoch_40,72.386%,1369.0,23.448%,321,1048,48631.0,73.764%,35872,12759,16666.0,27.199%,4533,12133,33334.0,94.978%,31660,1674,1077,23.120%,249,828,48923,73.471%,35944,12979,36193
resnet_3_epoch_45,72.114%,1312.0,21.113%,277,1035,48688.0,73.488%,35780,12908,16962.0,27.296%,4630,12332,33038.0,95.124%,31427,1611,1068,21.161%,226,842,48932,73.226%,35831,13101,36057
resnet_3_epoch_50,72.414%,1345.0,22.900%,308,1037,48655.0,73.783%,35899,12756,16913.0,27.576%,4664,12249,33087.0,95.334%,31543,1544,1070,23.178%,248,822,48930,73.491%,35959,12971,36207
resnet_3_epoch_55,72.132%,1321.0,22.029%,291,1030,48679.0,73.492%,35775,12904,17225.0,28.221%,4861,12364,32775.0,95.210%,31205,1570,1058,21.645%,229,829,48942,73.223%,35837,13105,36066
resnet_3_epoch_60,74.932%,1370.0,23.504%,322,1048,48630.0,76.381%,37144,11486,15511.0,29.650%,4599,10912,34489.0,95.297%,32867,1622,1080,23.333%,252,828,48920,76.071%,37214,11706,37466
resnet_3_epoch_65,75.480%,1335.0,25.169%,336,999,48665.0,76.860%,37404,11261,15184.0,29.577%,4491,10693,34816.0,95.499%,33249,1567,1050,24.952%,262,788,48950,76.564%,37478,11472,37740
resnet_3_epoch_70,75.692%,1376.0,25.654%,353,1023,48624.0,77.108%,37493,11131,15076.0,29.796%,4492,10584,34924.0,95.505%,33354,1570,1074,25.885%,278,796,48926,76.785%,37568,11358,37846
resnet_3_epoch_75,75.660%,1338.0,25.037%,335,1003,48662.0,77.052%,37495,11167,15084.0,29.740%,4486,10598,34916.0,95.498%,33344,1572,1036,25.000%,259,777,48964,76.732%,37571,11393,37830
resnet_3_epoch_80,75.804%,1362.0,26.358%,359,1003,48638.0,77.189%,37543,11095,15092.0,30.168%,4553,10539,34908.0,95.534%,33349,1559,1076,26.952%,290,786,48924,76.878%,37612,11312,37902
resnet_3_epoch_85,75.734%,1292.0,26.393%,341,951,48708.0,77.043%,37526,11182,14924.0,29.322%,4376,10548,35076.0,95.481%,33491,1585,1001,27.073%,271,730,48999,76.728%,37596,11403,37867
resnet_3_epoch_90,76.026%,1348.0,25.816%,348,1000,48652.0,77.417%,37665,10987,14730.0,29.477%,4342,10388,35270.0,95.466%,33671,1599,1035,26.570%,275,760,48965,77.071%,37738,11227,38013
resnet_3_epoch_95,75.990%,1334.0,26.537%,354,980,48666.0,77.346%,37641,11025,14737.0,29.538%,4353,10384,35263.0,95.403%,33642,1621,1019,26.791%,273,746,48981,77.014%,37722,11259,37995